                               *                           *                    
                               *                          ***                   
                               **                        *****                  
                               *                        *******                 
                              **  **                   *********                
           *                 ****  ****         **    ***********      *        
********************************************************************************
                *          *           *                                        
                *                      *                                        
                *                      *                                        
                *                      *                                        
                *                      *                                        
                *                      *                                        
                *                      *                                        
                *                      *                                        
                *                      *                                        
                *                      *                                        
                *     *                *                                        
                **********             *                                        
                         ***           *                                        
                          **********   *                                        
                                **     *                                        
                                 *    ***                                       
                                 *** ****                                       
                                   **   *                                       
                                    *****                                       
